
qwertyui
asdfg
zxcvbnm

alt shift enter - terminal

win left - swap left screen
win right - swap right screen
win shift left - move app left screen
win shift right - move app right screen
win up - toggle previous workspace
win ctrl right - toggle previous workspace
win shift wer - move window to screen
win wer - move focus to screen

win a - shrink sub window size
win z - grow sub window size


alt p - run
alt escape - kill
alt shift c - kill


win 1 - nixnote
win 2 - chromium
win 3 - terminal
win 4 - pcmanfm
win 5 - phpstorm
win 6 - keepassx
win 7 - geany
win 8 - vlc

win q - triple monitor
win u - hdmi monitor
win t - kill trayer
win j - desktops overview
win b - change background

win space - next window layout
alt space - toggle gaps
alt shift space - reset layout
alt tab - toggle focus
alt j - focus left window
alt k - focus right window
alt shift m - focus master window
alt enter - swap focused with master
alt shift jk - swap window left right
alt hl - shrink/grow master window
alt shift m - move window to named workspace
alt shift t - make tiled window
alt comma - increase master windows
alt shift comma - decrease master windows
alt shift 0 - exit
alt 0 - restart xmonad
alt o - screenshot

win -+ - volume down up
alt semicolon - fix keyboard
win k - fix remote
win v - check vpn

alt dot - app switcher
alt slash - custom launcher
alt apostrophe - clipboard
alt <   - shift windows to master
